111111111111111111
11P0K1C00100110C11
1K011110K100K11011
1KC000101110000011
111010000C00011111
10C011011K0K000111
1011110011C1110C11
101111101100111001
100K10K0C110111101
11000C000K1E1C0001
111111111111111111