1111111111111111
1P1100000C1E0KC1
10010K11K0110001
1K010C11C00001C1
11C001111KC101K1
1111111111111111