1111111111111
1P1100000C1E1
10010K11K0101
1K010C11C0001
11C001111KC11
1111111111111